#######################################
# ChronosPower v2.5 Ключевые слова
#######################################

#######################################
# Типы данных (KEYWORD1)
#######################################

ChronosPowerManager	KEYWORD1
Status	KEYWORD1
PowerProfile	KEYWORD1
PowerDomain	KEYWORD1
Peripheral	KEYWORD1
WakeupReason	KEYWORD1
EnergyMetrics	KEYWORD1
ThermalMetrics	KEYWORD1
PerformanceMetrics	KEYWORD1
WakeupPolicy	KEYWORD1
PowerPolicy	KEYWORD1
LogLevel	KEYWORD1

#######################################
# Методы и функции (KEYWORD2)
#######################################

begin	KEYWORD2
setProfile	KEYWORD2
getProfile	KEYWORD2
sleep	KEYWORD2
sleepFor	KEYWORD2
setCpuFrequency	KEYWORD2
getCpuFrequency	KEYWORD2
control	KEYWORD2
controlDomain	KEYWORD2
getEnergyMetrics	KEYWORD2
getThermalMetrics	KEYWORD2
getPerformanceMetrics	KEYWORD2
getWakeupReason	KEYWORD2
getSleepDurationMillis	KEYWORD2
registerWakeupCallback	KEYWORD2
registerEnergyCallback	KEYWORD2
registerThermalCallback	KEYWORD2
optimizeForBatteryLife	KEYWORD2
optimizeForPerformance	KEYWORD2
optimizeForThermal	KEYWORD2
statusToString	KEYWORD2
profileToString	KEYWORD2
wakeupReasonToString	KEYWORD2
isPeripheralAvailable	KEYWORD2

#######################################
# Константы (LITERAL1)
#######################################

# Статусы
OK	LITERAL1
FAILURE_GENERIC	LITERAL1
FAILURE_UNSUPPORTED_ARCH	LITERAL1
FAILURE_INVALID_PARAMETER	LITERAL1
FAILURE_TIMEOUT	LITERAL1
FAILURE_NO_WAKEUP_SOURCE	LITERAL1
FAILURE_PERIPHERAL_NOT_FOUND	LITERAL1

# Профили питания
MAX_PERFORMANCE	LITERAL1
HIGH_PERFORMANCE	LITERAL1
BALANCED_MOBILE	LITERAL1
LOW_POWER_ACTIVE	LITERAL1
ULTRA_LOW_POWER	LITERAL1
ADAPTIVE_BATTERY_LIFE	LITERAL1
CUSTOM_POLICY	LITERAL1

# Домены питания
CORE_LOGIC	LITERAL1
MEMORY_SYSTEM	LITERAL1
ANALOG_SUBSYSTEM	LITERAL1
DIGITAL_PERIPHERALS	LITERAL1
COMMUNICATIONS	LITERAL1
TIMERS_AND_PWM	LITERAL1
GPIO_PORTS	LITERAL1
ALL	LITERAL1

# Периферийные устройства
SYSTEM_CONTROLLER	LITERAL1
CPU_CORE_0	LITERAL1
CPU_CORE_1	LITERAL1
FLASH_CONTROLLER	LITERAL1
SRAM_CONTROLLER	LITERAL1
RTC_INTERNAL	LITERAL1
WATCHDOG_SYSTEM	LITERAL1
ADC_0_12BIT	LITERAL1
ADC_1_12BIT	LITERAL1
DAC_0_8BIT	LITERAL1
UART_0	LITERAL1
UART_1	LITERAL1
SPI_0	LITERAL1
SPI_1	LITERAL1
I2C_0	LITERAL1
I2C_1	LITERAL1
TIMER_0_8BIT_BASIC	LITERAL1
TIMER_1_16BIT_GENERAL	LITERAL1
WIFI_MAC_2_4GHZ	LITERAL1
BLUETOOTH_CONTROLLER	LITERAL1

# Причины пробуждения
UNKNOWN	LITERAL1
POWER_ON_RESET	LITERAL1
EXTERNAL_PIN_0	LITERAL1
EXTERNAL_PIN_1	LITERAL1
EXTERNAL_PIN_2	LITERAL1
RTC_ALARM_SECONDS	LITERAL1
WATCHDOG_TIMEOUT_INTERRUPT	LITERAL1
TOUCH_SENSOR_GLOBAL	LITERAL1
THERMAL_WARNING_HIGH	LITERAL1
BATTERY_LOW	LITERAL1

# Уровни логирования
NONE	LITERAL1
ERROR	LITERAL1
WARNING	LITERAL1
INFO	LITERAL1
DEBUG	LITERAL1

#######################################
# Макросы (LITERAL2)
#######################################

CPower	KEYWORD3
CHRONOS_SLEEP_MS	LITERAL2
CHRONOS_SET_PROFILE	LITERAL2
CHRONOS_ENABLE_PERIPHERAL	LITERAL2
CHRONOS_DISABLE_PERIPHERAL	LITERAL2
