#######################################
# ChronosPower v2.5 Ключевые слова (Русский)
#######################################

#######################################
# Типы данных (KEYWORD1)
#######################################

ChronosPowerManager	KEYWORD1
Status	KEYWORD1
PowerProfile	KEYWORD1
PowerDomain	KEYWORD1
Peripheral	KEYWORD1
WakeupReason	KEYWORD1
ResetReason	KEYWORD1
FlashState	KEYWORD1
SystemClockSource	KEYWORD1
EnergyMetrics	KEYWORD1
ThermalMetrics	KEYWORD1
PerformanceMetrics	KEYWORD1
ExternalInterruptConfig	KEYWORD1
RtcConfig	KEYWORD1
WatchdogConfig	KEYWORD1
UartWakeupConfig	KEYWORD1
ThermalPolicy	KEYWORD1
VoltagePolicy	KEYWORD1
AdaptiveScalingConfig	KEYWORD1
EnergyBudget	KEYWORD1
QuantumPowerConfig	KEYWORD1
NeuralPowerConfig	KEYWORD1
WakeupPolicy	KEYWORD1
PowerPolicy	KEYWORD1
LogLevel	KEYWORD1
LogEntry	KEYWORD1

#######################################
# Методы и функции (KEYWORD2)
#######################################

begin	KEYWORD2
apply	KEYWORD2
setProfile	KEYWORD2
getProfile	KEYWORD2
setCustomPolicy	KEYWORD2
getCustomPolicy	KEYWORD2
sleep	KEYWORD2
sleepUntil	KEYWORD2
quantumSleep	KEYWORD2
neuralSleep	KEYWORD2
hibernate	KEYWORD2
shutdown	KEYWORD2
setCpuFrequency	KEYWORD2
getCpuFrequency	KEYWORD2
setDynamicFrequencyScaling	KEYWORD2
setFrequencyRange	KEYWORD2
setQuantumFrequencyScaling	KEYWORD2
setNeuralFrequencyScaling	KEYWORD2
control	KEYWORD2
massControl	KEYWORD2
setClockGatingForDomain	KEYWORD2
enablePeripheralGroup	KEYWORD2
disablePeripheralGroup	KEYWORD2
setPeripheralPowerIsland	KEYWORD2
enableAdaptiveScaling	KEYWORD2
disableAdaptiveScaling	KEYWORD2
setEnergyBudget	KEYWORD2
enableQuantumOptimization	KEYWORD2
enableNeuralOptimization	KEYWORD2
optimizeForBatteryLife	KEYWORD2
optimizeForPerformance	KEYWORD2
optimizeForThermal	KEYWORD2
optimizeForEnergyHarvesting	KEYWORD2
optimizeForCarbonFootprint	KEYWORD2
optimizeMultiObjective	KEYWORD2
getEnergyMetrics	KEYWORD2
getThermalMetrics	KEYWORD2
getPerformanceMetrics	KEYWORD2
getInternalTemperature	KEYWORD2
getCoreVoltage	KEYWORD2
getFlashState	KEYWORD2
getBatteryLevel	KEYWORD2
getBatteryHealth	KEYWORD2
getPowerEfficiency	KEYWORD2
getEnergyEfficiency	KEYWORD2
getCarbonFootprint	KEYWORD2
registerWakeupCallback	KEYWORD2
registerErrorCallback	KEYWORD2
registerEnergyCallback	KEYWORD2
registerThermalCallback	KEYWORD2
registerPerformanceCallback	KEYWORD2
registerBatteryCallback	KEYWORD2
registerFrequencyCallback	KEYWORD2
registerPolicyCallback	KEYWORD2
getWakeupReason	KEYWORD2
getResetReason	KEYWORD2
clearWakeupReason	KEYWORD2
getSleepDurationMillis	KEYWORD2
getTotalSleepTime	KEYWORD2
getTotalUptime	KEYWORD2
getWakeupCount	KEYWORD2
getAverageSleepDuration	KEYWORD2
getSleepEfficiency	KEYWORD2
synchronizeSystemTime	KEYWORD2
calibrateInternalOscillator	KEYWORD2
setSystemClockSource	KEYWORD2
calibrateEnergyMeasurement	KEYWORD2
calibrateThermalSensors	KEYWORD2
calibrateQuantumSensors	KEYWORD2
setLogLevel	KEYWORD2
getLogLevel	KEYWORD2
getLogEntries	KEYWORD2
clearLog	KEYWORD2
enablePerformanceMonitoring	KEYWORD2
enableEnergyProfiling	KEYWORD2
enableThermalProfiling	KEYWORD2
generatePowerReport	KEYWORD2
createPeripheralGroup	KEYWORD2
saveConfiguration	KEYWORD2
loadConfiguration	KEYWORD2
exportConfiguration	KEYWORD2
importConfiguration	KEYWORD2
cloneConfiguration	KEYWORD2
setPlatformSpecificOption	KEYWORD2
getPlatformSpecificOption	KEYWORD2
enablePlatformOptimizations	KEYWORD2
disablePlatformOptimizations	KEYWORD2
trainPowerModel	KEYWORD2
loadPowerModel	KEYWORD2
savePowerModel	KEYWORD2
predictPowerConsumption	KEYWORD2
predictBatteryLife	KEYWORD2
predictOptimalFrequency	KEYWORD2
enableReinforcementLearning	KEYWORD2
initializeQuantumProcessor	KEYWORD2
runQuantumOptimization	KEYWORD2
getQuantumState	KEYWORD2
setQuantumParameters	KEYWORD2
enableEnergyHarvesting	KEYWORD2
setSolarPanelWatts	KEYWORD2
setKineticHarvesterWatts	KEYWORD2
setRfHarvesterWatts	KEYWORD2
getHarvestedEnergy	KEYWORD2
optimizeHarvestingEfficiency	KEYWORD2
enableCarbonTracking	KEYWORD2
setCarbonIntensity	KEYWORD2
optimizeForSustainability	KEYWORD2
enableSecurityMode	KEYWORD2
setTamperDetection	KEYWORD2
enableSafetyShutdown	KEYWORD2
setSafetyLimits	KEYWORD2
performSecurityAudit	KEYWORD2

#######################################
# Методы Fluent интерфейса (KEYWORD2)
#######################################

withProfile	KEYWORD2
withFrequency	KEYWORD2
withPeripheral	KEYWORD2
withDomain	KEYWORD2
withEnergyBudget	KEYWORD2
withThermalLimit	KEYWORD2
withAdaptiveScaling	KEYWORD2
withQuantumOptimization	KEYWORD2
withNeuralOptimization	KEYWORD2
withLogging	KEYWORD2
withVoltageScaling	KEYWORD2
withClockGating	KEYWORD2
withPowerGating	KEYWORD2
withRetentionMode	KEYWORD2

#######################################
# Статические утилиты (KEYWORD2)
#######################################

statusToString	KEYWORD2
profileToString	KEYWORD2
peripheralToString	KEYWORD2
wakeupReasonToString	KEYWORD2
getPeripheralsInDomain	KEYWORD2
isPeripheralAvailable	KEYWORD2
estimateEnergyConsumption	KEYWORD2
calculateOptimalFrequency	KEYWORD2
recommendProfile	KEYWORD2
validatePowerPolicy	KEYWORD2
optimizePowerPolicy	KEYWORD2

#######################################
# Вспомогательные функции (KEYWORD2)
#######################################

CPower	KEYWORD2
sleepFor	KEYWORD2
quantumSleepFor	KEYWORD2
neuralSleepFor	KEYWORD2
hibernateFor	KEYWORD2
enableUltraLowPowerMode	KEYWORD2
enableQuantumEfficiencyMode	KEYWORD2
enableNeuralPowerMode	KEYWORD2
enableHighPerformanceMode	KEYWORD2
enableAdaptiveMode	KEYWORD2
enableEnergyHarvestingMode	KEYWORD2
enableBatteryPreservationMode	KEYWORD2
enableEmergencyPowerMode	KEYWORD2
calculateQuantumEfficiency	KEYWORD2
calculateNeuralOptimization	KEYWORD2
calculateEnergyEfficiency	KEYWORD2
calculateThermalEfficiency	KEYWORD2
calculateCarbonFootprint	KEYWORD2

#######################################
# Константы и перечисления (LITERAL1)
#######################################

# Значения статуса
OK	LITERAL1
FAILURE_GENERIC	LITERAL1
FAILURE_UNSUPPORTED_ARCH	LITERAL1
FAILURE_UNSUPPORTED_FEATURE	LITERAL1
FAILURE_INVALID_PARAMETER	LITERAL1
FAILURE_TIMEOUT	LITERAL1
FAILURE_INSUFFICIENT_MEMORY	LITERAL1
FAILURE_SYSTEM_STATE_INVALID	LITERAL1
FAILURE_CONFIG_LOCKED	LITERAL1
FAILURE_PERIPHERAL_ACTIVE	LITERAL1
FAILURE_REGISTER_WRITE_PROTECTED	LITERAL1
FAILURE_HARDWARE_FAULT	LITERAL1
FAILURE_INVALID_FREQUENCY	LITERAL1
FAILURE_PLL_LOCK_FAILED	LITERAL1
FAILURE_OSCILLATOR_FAILED	LITERAL1
FAILURE_CLOCK_GATING_FAILED	LITERAL1
FAILURE_PRECISION_UNATTAINABLE	LITERAL1
FAILURE_VOLTAGE_SCALE	LITERAL1
FAILURE_FLASH_POWERDOWN	LITERAL1
FAILURE_BOD_CONFIG	LITERAL1
FAILURE_THERMAL_PROTECTION	LITERAL1
FAILURE_POWER_DOMAIN_LOCKED	LITERAL1
FAILURE_NO_WAKEUP_SOURCE	LITERAL1
FAILURE_WAKEUP_CONFLICT	LITERAL1
FAILURE_RTC_UNINITIALIZED	LITERAL1
FAILURE_TIMER_UNAVAILABLE	LITERAL1
FAILURE_INTERRUPT_MAP	LITERAL1
FAILURE_PERIPHERAL_NOT_FOUND	LITERAL1
FAILURE_DMA_CHANNEL_ACTIVE	LITERAL1
FAILURE_CALLBACK_NOT_SET	LITERAL1
FAILURE_ADAPTIVE_SCALING_DISABLED	LITERAL1
FAILURE_ENERGY_BUDGET_EXCEEDED	LITERAL1
FAILURE_THERMAL_THROTTLING_ACTIVE	LITERAL1
FAILURE_BATTERY_CRITICAL	LITERAL1
FAILURE_SECURITY_VIOLATION	LITERAL1
FAILURE_POWER_RAIL_UNSTABLE	LITERAL1
FAILURE_CLOCK_DOMAIN_CONFLICT	LITERAL1
FAILURE_VOLTAGE_REGULATOR_FAULT	LITERAL1
FAILURE_POWER_ISLAND_ISOLATION	LITERAL1
FAILURE_DYNAMIC_SCALING_OVERFLOW	LITERAL1

# Профили питания
MAX_PERFORMANCE	LITERAL1
HIGH_PERFORMANCE	LITERAL1
BALANCED_DESKTOP	LITERAL1
BALANCED_MOBILE	LITERAL1
LOW_POWER_ACTIVE	LITERAL1
ULTRA_LOW_POWER	LITERAL1
DEEP_SLEEP_PREP	LITERAL1
HIBERNATION_PREP	LITERAL1
SHUTDOWN_PREP	LITERAL1
MACHINE_LEARNING_INFERENCE	LITERAL1
AUDIO_PROCESSING	LITERAL1
VIDEO_PROCESSING	LITERAL1
DATA_LOGGING	LITERAL1
SENSOR_FUSION	LITERAL1
COMMUNICATION_INTENSIVE	LITERAL1
COMPUTATION_INTENSIVE	LITERAL1
ADAPTIVE_PERFORMANCE	LITERAL1
ADAPTIVE_BATTERY_LIFE	LITERAL1
ADAPTIVE_THERMAL	LITERAL1
ADAPTIVE_WORKLOAD	LITERAL1
ADAPTIVE_ENERGY_HARVEST	LITERAL1
QUANTUM_EFFICIENCY	LITERAL1
NEURAL_POWER_MANAGEMENT	LITERAL1
PREDICTIVE_SCALING	LITERAL1
ENERGY_HARVESTING_SOLAR	LITERAL1
ENERGY_HARVESTING_KINETIC	LITERAL1
ENERGY_HARVESTING_RF	LITERAL1
BATTERY_PRESERVATION	LITERAL1
EMERGENCY_POWER	LITERAL1
CUSTOM_POLICY	LITERAL1

# Домены питания
CORE_LOGIC	LITERAL1
MEMORY_SYSTEM	LITERAL1
CACHE_SYSTEM	LITERAL1
ANALOG_SUBSYSTEM	LITERAL1
DIGITAL_PERIPHERALS	LITERAL1
COMMUNICATIONS	LITERAL1
TIMERS_AND_PWM	LITERAL1
GPIO_PORTS	LITERAL1
SECURITY_MODULES	LITERAL1
MULTIMEDIA	LITERAL1
RADIO_SUBSYSTEM	LITERAL1
SENSOR_INTERFACES	LITERAL1
MOTOR_CONTROL	LITERAL1
HIGH_SPEED_IO	LITERAL1
LOW_POWER_PERIPHERALS	LITERAL1
DEBUG_INTERFACES	LITERAL1
CPU_CORE_0	LITERAL1
CPU_CORE_1	LITERAL1
CPU_CORE_2	LITERAL1
CPU_CORE_3	LITERAL1
L1_CACHE	LITERAL1
L2_CACHE	LITERAL1
L3_CACHE	LITERAL1
MEMORY_CONTROLLER	LITERAL1
DMA_CONTROLLER	LITERAL1
VOLTAGE_REGULATORS	LITERAL1
CLOCK_GENERATORS	LITERAL1
POWER_ISLANDS	LITERAL1
RETENTION_LOGIC	LITERAL1
ALL	LITERAL1

# Уровни логирования
NONE	LITERAL1
CRITICAL	LITERAL1
ERROR	LITERAL1
WARNING	LITERAL1
INFO	LITERAL1
DEBUG	LITERAL1
VERBOSE	LITERAL1
TRACE	LITERAL1

# Состояния флеш-памяти
ACTIVE	LITERAL1
IDLE	LITERAL1
DEEP_POWER_DOWN	LITERAL1
STANDBY	LITERAL1
RETENTION	LITERAL1
UNKNOWN	LITERAL1

# Источники системных часов
INTERNAL_RC_FAST	LITERAL1
INTERNAL_RC_SLOW	LITERAL1
INTERNAL_RC_ULTRA_LOW_POWER	LITERAL1
EXTERNAL_CRYSTAL	LITERAL1
EXTERNAL_OSCILLATOR	LITERAL1
PLL_INTERNAL	LITERAL1
PLL_EXTERNAL	LITERAL1
PLL_FRACTIONAL	LITERAL1
QUANTUM_OSCILLATOR	LITERAL1
AUTO_SELECT	LITERAL1

#######################################
# Макросы (LITERAL2)
#######################################

CHRONOS_SLEEP_MS	LITERAL2
CHRONOS_QUANTUM_SLEEP_MS	LITERAL2
CHRONOS_NEURAL_SLEEP_MS	LITERAL2
CHRONOS_SLEEP_UNTIL	LITERAL2
CHRONOS_SET_PROFILE	LITERAL2
CHRONOS_ENABLE_PERIPHERAL	LITERAL2
CHRONOS_DISABLE_PERIPHERAL	LITERAL2
CHRONOS_OPTIMIZE_BATTERY	LITERAL2
CHRONOS_OPTIMIZE_PERFORMANCE	LITERAL2
CHRONOS_OPTIMIZE_THERMAL	LITERAL2
CHRONOS_ENABLE_QUANTUM	LITERAL2
CHRONOS_ENABLE_NEURAL	LITERAL2
